








X
X
X                                                                        
X                                                                     XXX                                                                             XXX                                                                                           XXXX         XXXX
X                                                                     XXX                                                                             XXX                                                                                           XXXX         XXXX
X                                                                     XXX                                                                   XXXXX     XXX                                                                                        XXXXXXX         XXXX
X                                       XXXXXXXXXXXXXXXXXXXXXXXXXX    XXX                                                                   XXXXX     XXX                                                                                        XXXXXXX         XXXX                               B                                                                                                                   T
X                                       XXXXXXXXXXXXXXXXXXXXXXXXXX    XXX                                                         XXXXX               XXX                                                                                     XXXXXXXXXX         XXXX              B                                                                                                                    B               T
X                                                                                                                                 XXXXX               XXX                                                                                     XXXXXXXXXX         XXXX                                                                                                                                                   T
X                                                     XXXXXXXXXXXXXXXXXXXXXXXXXXXXXX                                   XXXXXX                         XXX                                                                                  XXXXXXXXXXXXX         XXXX                       B  XXXXXXXXXX                                                                               B                        B      T
X                                                     XXXXXXXXXXXXXXXXXXXXXXXXXXXXXX                                   XXXXXX                         XXX                                                                                  XXXXXXXXXXXXX         XXXX          XXXXXXXXXX                                                                                                          XXXXXXXXXX           T
XP                                                                                                                                       E            XXX     F                                                          F     XXXXXXXXXXXXXXXXXXXXXXXXX         XXXX                                                                                                                                                   T
XXXXXXXXXXXXXXXXXXXXXXXXXXXXXXXXXXXXXXXXXXXXXXXXXXXXXXXXXXXXXXXXXXXXXXXXXXXXXXXXXXXXXXXXXXXXXXXXXXXXXXXXXXXXXXXXXXXXXXXXXXXXXXXXXXXXXXXXXXXXXXXXXXXXXXXXXXXXXXXXXXXXXXXXXXXXXXXXXXXXXXXXXXXXXXXXXXXXXXXXXXXXXXXXXXXXXXXXXXXXXXXXXXXXXXXXXXXXXXXXXXXXXXXX         XXXXXXXXXXXXXXXXXXXXXXXXXXXXXXXXXXXXXXXXXXXXXXXXXXXXXXXXXXXXXXXXXXXXXXXXXXXXXXXXXXXXXXXXXXXXXXXXXXXXXXXXXXXXXXXXXXXXXXXXXXXXXXXXXXXXXXXXXXXXXXXXXXXXXXXX
XXXXXXXXXXXXXXXXXXXXXXXXXXXXXXXXXXXXXXXXXXXXXXXXXXXXXXXXXXXXXXXXXXXXXXXXXXXXXXXXXXXXXXXXXXXXXXXXXXXXXXXXXXXXXXXXXXXXXXXXXXXXXXXXXXXXXXXXXXXXXXXXXXXXXXXXXXXXXXXXXXXXXXXXXXXXXXXXXXXXXXXXXXXXXXXXXXXXXXXXXXXXXXXXXXXXXXXXXXXXXXXXXXXXXXXXXXXXXXXXXXXXXXXX E E E E XXXXXXXXXXXXXXXXXXXXXXXXXXXXXXXXXXXXXXXXXXXXXXXXXXXXXXXXXXXXXXXXXXXXXXXXXXXXXXXXXXXXXXXXXXXXXXXXXXXXXXXXXXXXXXXXXXXXXXXXXXXXXXXXXXXXXXXXXXXXXXXXXXXXXXXX
XXXXXXXXXXXXXXXXXXXXXXXXXXXXXXXXXXXXXXXXXXXXXXXXXXXXXXXXXXXXXXXXXXXXXXXXXXXXXXXXXXXXXXXXXXXXXXXXXXXXXXXXXXXXXXXXXXXXXXXXXXXXXXXXXXXXXXXXXXXXXXXXXXXXXXXXXXXXXXXXXXXXXXXXXXXXXXXXXXXXXXXXXXXXXXXXXXXXXXXXXXXXXXXXXXXXXXXXXXXXXXXXXXXXXXXXXXXXXXXXXXXXXXXXXXXXXXXXXXXXXXXXXXXXXXXXXXXXXXXXXXXXXXXXXXXXXXXXXXXXXXXXXXXXXXXXXXXXXXXXXXXXXXXXXXXXXXXXXXXXXXXXXXXXXXXXXXXXXXXXXXXXXXXXXXXXXXXXXXXXXXXXXXXXXXXXXXXXXXXXXXXXXXXXX